####################
#P....#.......*....#
#.##..#.#####.###..#
#..#....#...#......#
##.######.#.#####.##
#..*......#........#
#.#########.####...#
#.........#....#...#
#....*.........X...#
####################
